:::::::::::::::::::
:..#.......#......:
:..##..???.....B..:
:..#....:.........:
:.?..:#..#:.......:
:.?....#####......:
:..###:::::######.:
:.??..???::?..???.:
:.?...##..##......:
:.###....???......:
:.##..?..#??...??.:
:.....?...##....?.:
:..@..?....##.::?.:
:.....?....##:##..:
:.....?....##:##..:
:.....???.....##..:
:..........##.::..:
:.....?....##.:#..:
:::::::::::::::::::