:::::::::::::::::
:.#.......#.....:
:.##..???.....B.:
:.#....:........:
:?..:#..#:......:
:?....#####.....:
:.###:::::######:
:??..???::?..???:
:?...##..##.....:
:###....???.....:
:##..?..#??...??:
:....?...##....?:
:.@..?....##.::?:
:....?....#####.:
:::::::::::::::::